판타지 : 판타지물
일상 : 일상
스릴러 : 스릴러
드라마 : 드라마
스포츠 : 스포츠
먼치킨 : 먼치킨
학원로맨스 : 학원
로판 : 로맨스판타지
게임판타지 : 게임
동물 : 동물
집착물 : 집착
친구>연인 : 친구>연인
짝사랑 : 짝사랑
육아물 : 육아물
사내연애 : 사내연애
까칠남 : 까칠남
동양풍판타지 : 동양풍
차원이동 : 차원이동
퓨전사극 : 퓨전사극
sf : SF
오컬트 : 오컬트
빙의 : 빙의
회귀 : 회귀
학원물 : 학원물
삼각관계 : 삼각관계
범죄 : 범죄
서바이벌 : 서바이벌
아포칼립스 : 아포칼립스
직진남 : 직진남
성장물 : 성장물
소꿉친구 : 소꿉친구
좀비 : 좀비
고인물 : 고인물
재벌 : 재벌
연상연하 : 연상연하
인외존재 : 인외존재
역하렘 : 역하렘
다정남 : 다정남
타임슬립 : 타임슬립
로맨스 : 로맨스판타지, 로맨틱코미디
개그 : 개그물
무협/사극 : 무협물
연예계 : 연예계물, 가수, 배우
축구 : 스포츠물
격투기 : 격투, 검사
오피스로맨스 : 오피스물, 사내연애
스포츠성장 : 스포츠능력물, 성장물
두뇌싸움 : 능력녀
힘숨찐 : 절륜남, 착각물
무해한 : 무심, 냉정
캠퍼스로맨스 : 캠퍼스물
재회 : 오래된연인
비밀연애 : 초월적존재
머니게임 : 경쟁구도, 복수물
아이돌 : 가수
걸크러시 : 강공, 까칠한
4차원 : 초월적존재, 미스테리
다크히어로 : 악녀
히어로 : 영웅/신화
환골탈태 : 유혹녀, 치유물
세계관 : 시월드
느와르 : 범죄, 추리물
서스펜스 : 
사이다 : 사이다녀
인플루언서 : BJ
헌터물 : 서바이벌
최강자전 : 강공
농구 : 스포츠물
판무 : 권, 귀족공
현실로맨스 : 현대로맨스
감성드라마 : 드라마
해외작품 : 외국인남/혼혈
이능력배틀물 : 초능력, 능력남
동아리 : 학생
후회물 : 후회남, 찌질
선결혼후연애 : 결혼
음식&요리 : 요리사, 먹방/요리
소년왕도물 : 왕족/귀족
로맨스코미디 : 로맨틱코미디
의학드라마 : 의사, 메디컬
슈퍼스트링 : 능력녀
스핀오프 : 라이벌, 스릴 넘치는
다크판타지 : 미스테리
청춘로맨스 : 미인
2030연애 : 현대로맨스, 성장물
궁중로맨스 : 궁정로맨스, 왕족/귀족
러블리 : 귀여운, 사랑스러운
괴담 : 호러
역사물 : 시대물
감염 : 좀비
레드스트링 : 운명, 피폐물
계약연애 : 계약관계
영화원작웹툰 : 원작소설
야구 : 스포츠물
힐링 : 힐링물, 치유물
법정드라마 : 법조인
음악 : 가수
복수극 : 복수물
블루스트링 : 검사, 탐정
폭스남 : 깽판, 오만남
전남친 : 연예계물
혐관로맨스 : 집착남
밀리터리 : 군대, 군인
성장드라마 : 성장물, 성장
직업드라마 : 전문직
이세계 : 타임슬립
계략여주 : 계략녀
하이틴 : 하렘물, 학생
사이비종교 : 귀신, 사이다남
아이돌연애 : 가수, 연예계물
프리퀄 : 전쟁
구원서사 : 현대물
성별반전 : 빙의물
햇살캐 : 꽃같은
하이퍼리얼리즘 : 현대물
고자극로맨스 : 달달물
